

NO textures/bluestone.xpm
SO textures/grass.xpm
WE textures/mossy.xpm
EA textures/wood.xpm

F 100,100,34
C 100, 0,50

11111111111111111111111111
10000000000000000000001
1011000000000000000001
1001000000000000000000001
1111111110000000000000000001
1000000000000001110111111111111
11110111111111011100000010001
11110111111111011101010010001
11000000110101011100000010001
10000000000000001100000010001
10000000000000001101010010001
1100000111010101111100N0111
11110111 1110101 101111010001
11111111 1111111 111111111111
